x x x x x x x x x x
x _ _ _ x _ _ x f x
x _ x _ x x _ _ _ x
x _ x _ _ _ x _ x x
x x x _ x x x _ x x
x _ _ _ x _ _ _ x x
x _ x _ x _ x x _ x
x _ x x x _ x _ _ x
x p1n1 _ _ _ _ _ _ x x
x x x x x x x x x x
